0 0 0 0 0 0 0 0 0 0 0 0 0 0 0 0 0 0
0 0 1 1 1 1 1 1 1 1 1 1 1 1 1 1 0 0
0 1 3 3 3 3 3 3 3 3 3 3 3 3 3 3 1 0 
0 1 3 3 3 3 3 3 3 3 3 3 3 3 3 3 1 0 
0 1 3 3 3 3 3 3 3 3 3 3 3 3 3 3 1 0 
0 1 3 3 1 1 1 3 3 3 3 1 1 1 3 3 1 0
0 1 3 3 1 3 3 3 3 3 3 3 3 1 3 3 1 0
0 1 3 3 1 3 3 1 1 1 1 3 3 1 3 3 1 0
0 1 3 3 1 3 3 1 3 3 1 3 3 1 3 3 1 0
0 1 3 3 1 3 3 1 3 3 1 3 3 1 3 3 1 0 
0 1 3 3 1 3 3 1 1 1 1 3 3 1 3 3 1 0
0 1 3 3 1 3 3 3 3 3 3 3 3 1 3 3 1 0
0 1 3 3 1 1 1 3 3 3 3 1 1 1 3 3 1 0
0 1 3 3 3 3 3 3 3 3 3 3 3 3 3 3 1 0
0 1 3 8 9 2 10 3 3 3 3 3 3 3 3 3 1 0
0 1 3 4 5 6 7 3 3 3 3 3 3 3 3 3 1 0
0 0 1 1 1 1 1 1 1 1 1 1 1 1 1 1 0 0
0 0 0 0 0 0 0 0 0 0 0 0 0 0 0 0 0 0 
